Общие случаи переводов слов и выражений
=======================================

Break - Перерыв (на отдельном слайде)
Exercises lecture - лекция
Lab - Лабораторная работа
Qt in education - Qt в образовании
Solution tips - Советы по выполнению

anchor layout - компоновка по якорям
binding - привязка
bleeding edge - новейший (http://forum.lingvo.ru/actualthread.aspx?tid=9557)
build process - процесс сборки
callbacks - функции обратного вызова
child - потомок
class declaration - объявление класса
compile-time - время компиляции
connection - соединение
declaration - объявление
definition - описание (определение)
delegate - делегат
directory - каталог
enum (enumeration) - перечисление
fluid user interface - подвижный пользовательский интерфейс
(in) fluid way - плавно
framework - фреймворк (http://ru.wikipedia.org/wiki/%D0%A4%D1%80%D0%B5%D0%B9%D0%BC%D0%B2%D0%BE%D1%80%D0%BA)
hardcoded - жестко закодированный
infinite loop - бесконечный цикл
inheritance - наследование
installer - установщик
instance - экземпляр
keyword - ключевое слово
leaking memory - утечка памяти
margins - поля
member variable - переменная класса, классовая переменная (в зависимости от контекста)
memory management - управление памятью
metadata - метаданные
method, function - функция
parent - родитель (предок)
run-time - время исполнения
scope - область видимости
statement - оператор
web browser - веб-браузер
widget - виджет

to allocate memory - выделить память
to anchor - прикреплять
to emit signal - испустить сигнал
to explicitly free memory - явно освободить память
to implement - реализовать
to instantiate - создать экземпляр
to render - отрисовывать, формировать изображение (http://lingvo.abbyyonline.com/en/en-ru/render)
to return value - возвращать значение
